--------------------
--------------------
--------------------
--------------------
--NLUUUUUUUUUURT----
--H      UU    G----
--H     . 3   .G----
--H.U   $$$ U  G----
--H           @B----
--YLUUUUUUUUUURB----
--------------------
--------------------
--------------------
;